//////////////////////
/              /n    /
/  ////////////////  /
/  /     /           /
/  /  /  /  //////////
/     /     /        /
/  /  /////////////  /
/  /o    /  / n      /
/  ////  /  ///////  /
/  /     /           /
/  ////  /  //////////
/  /     /  /  /     /
////  /  /  /  /  ////
/     /             n/
//////////////////////
