//////////////////////////////////////////////////
/   //   /     / / / /     /     /     /   /   /
/ / / / / / / / / / / / / / / / / / / / / / / / /
/ / /   /   /     / /   / / / / / / / / / / /   /
/ / / / / / / / / / / / / / / / / / / / / / / / /
/ / / /   / / / / / /   / / / / / / / / / / / / /
/ / / / / / / / / / / / / / / / / / / / / / / / /
/     /     / / / /   /   / /   /   / /   /   / /
/ / / / / / / / / / / / / / / / / / / / / / / / /
/ / /   /   / / / / / / /   /   / / / / /   /   /
/ / / / / / / / / / / / / / / / / / / / / / / / /
/ / / / / / /   /   / /   / / / / / / / / / /   /
/ / / / / / / / / / / / / / / / / / / / / / / / /
/ /   /     / / / / /   / / / / / / / / / / / / /
/ / / / / / / / / / / / / / / / / / / / / / / / /
/ / /   /   / / / / / / / / / / / / /   / / /   /
/ / / / / / / / / / / / / / / / / / / / / / / / /
/ / / / / / / / o /   /   /   /   /   / n / / / /
//////////////////////////////////////////////////
