///////////
/  o  /   /
/ ///// / /
/       / /
/ / /// ///
/ / /n/ / /
/ / / / / /
/ / / /  //
///// / /n/
/         /
///////////
