///////////////////////
/ /   /     / / / / / /
/ / / / / / / / / / / /
/       /   /     /   /
/ / / / / / / / / / / /
/ / /   /     / /   / /
/ / / / / / / / / / / /
/   /   / o /       / /
/ / / / / / / / / / / /
/ / / / / / / / / / / /
/ /   / / / /   /     /
/ / / / / / / / / / / /
/     /   /n/ /   /   /
///////////////////////