//////////////////////////////////////////////////
/            //      /                           /
/o          /// //// /                           /
////// /////    /    /                           /
-----/ /----/ /// ////                           /
////// ////// /-/    /                           /
/             /-///                         n    /
//////////////////////////////////////////////////
