//////////////////////////////////////////////////
/           n//      /                           /
/o          /// //// /                           /
////// /////    /    /                           /
-----/ /----/ /// ////                           /
////// ////// /-/    /                           /
/             /-///                         n    /
//////////////////////////////////////////////////
