//////////////-
/            /-
/           ///
////// /////  /
-----/ /----/ /
////// /////  /
/             /
///////////////
