////////////////////////////////////
/ / / / / / / / / / / / / / / / / /
/ o   / /   /       /   /     / /
/ / / / / / / / / / / / / / / / /
/ /   / /   /     /   / /   /   /
/ / / / / / / / / / / / / / / / /
/ /     /     /   / / /   /     /
/ / / / / / / / / / / / / / / / /
/   / /     / /   /   / / / n / /
////////////////////////////////////