///////////////////
/              / o/
/  ////  /  ////  /
////  /  /  /     /
/     ////  ////  /
/n /        /     /
////  ///////  ////
/        /        /
///////  /  /  /  /
/n /        /  /  /
/  /////////////  /
/                 /
///////////////////
