////////////////
/o       /     /
/  /  ////  /  /
/  /  n  /  /  /
/  ///////  /  /
/  /        /  /
/  /  ////  /  /
/  /  /     /  /
/  /  ////  /  /
/     / n   /  /
////////////////
