//////////////////////////////////////////////////
/            //      /                           /
/           /// //   /                           /
////// /////    /    /                           /
-----/ /----/ ///    /                           /
////// ////// /-/    /                           /
/             /-/                           n    /
//////////////////////////////////////////////////
