111111111111110
122222222221210
122222222221210
111111211111221
000001210000121
111111211111221
122222222222221
111111111111111
