/////////////////////////
/                       /
/  /  ////  //////////  /
/  / n/     /  /        /
/////////////  /  ///////
/  /        /  /        /
/  ////  /  /  /  ///////
/     /  /n /           /
////  /  //////////  /  /
/                    /  /
/  /  ///////  ////  /  /
/  /  /  /        /  /  /
/  ////  ////  /  ///////
/           /  /  /     /
/  ////  ///////  /  /  /
/ o/           /     /n /
/////////////////////////
